1111111111111
10000000000C1
1100000000001
1P0000E000001
1111111111111
